10
########
#G     #
#      #
#      #
#      #
#P S   #
########